#####################
#...................#
#..#x##x........o...#
#.....#.......o.....#
#.....x.............#
#..####...........o.#
#@x...............o.#
#####################
--by 165314038 Daniel